##########n
###...o###n
#......###n
#..####.@#n
#........#n
##########n