##########
###...o###
#......###
#..####.@#
#........#
##########