########n
#@...#.#n
#..#...#n
#....###n
#.##...#n
#....#o#n
########n
